%%%%%%%%%%%%%%%%%
%  G   %.%      %
%    %%%H%  %%  %
%%%%%% % %% %%  %
%P            JG%
% % % % %%%% %%%%
% %%% % %  %H%  %
%     %.%  %.%  %
%%%%%%%%%%%%%%%%%